+++++++++++++
+S         E+
+ ++++++++ ++
+ +       + +
+ + +++ + + +
+   +   + + +
+++++ +++++ +
+     +     +
+++++++++++++